---#-#---------#--#--#-#-
----#-----#------#-#-#---
###-------#-#----#----#-#
-----#-#-#-#-----#-#--#--
-------####--#---#-#--#--
##-#-#-#-#-#-#-#-----#-#-